Alone in Deep Island
An Interactive Fiction by IM/EBA Alliance of Game Masters
Release 1 / Serial number 130628 / Inform 7 build 6G60 (I6/v6.32 lib 6/12N) SD

Carla's Cell
This is the room you've been kept since you arrived in this cursed place. Here you witnessed the suffering and despair of many subjects. Yesterday a poor girl was so cruelly abused that she died. Whenever an experience like that fails these guards start patrolling more often. It seems they are observing how you behave. 

This cell is so dirty. It looks like a prison. It even smells like a prison. An uncomfortable iron bed is on the corner of the room. There is also a window on the east wall. You can see the other cells through it.

A barred door leads southeast to the prison hall.

Through the barred door you can see a keeper sleeping noisily outside. He is sitting on a chair on the corner of the prison hall. An iron key hanging on his belt catches your eyes.

>lev key
You focus you thoughts on the key. Suddenly, but gently, it starts levitating and moving towards yourself. It passess throught the barred door. You reach out and easily take it still in the air. The key is yours!

* * *

>s
(first opening the heavy iron door)

Corridor
You can see a black door, a knowledge door and a heavy iron door here.

>s
(first opening the knowledge door)

Study
You can see an automatic door, a knowledge door and a comfort chair here.

>sit on chair
You activated a hidden device. The safe is open. You can see a card inside it.

You are now seated on the comfort chair.

>take card
You cannot reach the safe from here.

* * *

>sit on chair
You activated a hidden device. The safe is open. You can see a card inside it.

You are now seated on the comfort chair.

>lev card
Once more you focus your telekinetic power. You easily make the id card levitate towards you.

>unlock automatic door with id card
You unlock the automatic door.

>s
(first getting off the comfort chair)
The safe closed as you got off the chair.

(first opening the automatic door)
Video Room
You can see an automatic door here.

* * *

>sit on chair
You activated a hidden device. The safe is open. You can see a card inside it.

You are now seated on the comfort chair.

>get off
The safe closed as you got off the chair.

You get off the comfort chair.

Study
You can see an automatic door, a knowledge door and a comfort chair here.

>take card
You can't see any such thing.

* * *

>s
(first opening the knowledge door)

Study
You can see an automatic door, a knowledge door and a comfort chair here.

>take id card
You can't see any such thing.

* * *

>s
(first opening the knowledge door)

Study
You can see an automatic door, a knowledge door and a comfort chair here.

>s
(first opening the automatic door)
It seems to be locked.

* * *

>look
Carla's Cell
This cell is so dirty. It looks like a prison. It even smells like a prison. An uncomfortable iron bed is on the corner of the room. There is also a window on the east wall. You can see the other cells through it.

A barred door leads southeast to the prison hall.

Through the barred door you can see a keeper sleeping noisily outside. He is sitting on a chair on the corner of the prison hall. An iron key hanging on his belt catches your eyes.

>look
Carla's Cell
This cell is so dirty. It looks like a prison. It even smells like a prison. An uncomfortable iron bed is on the corner of the room. There is also a window on the east wall. You can see the other cells through it.

A barred door leads southeast to the prison hall.

Through the barred door you can see a keeper sleeping noisily outside. He is sitting on a chair on the corner of the prison hall. An iron key hanging on his belt catches your eyes.

>levitate key
You focus you thoughts on the key. Suddenly, but gently, it starts levitating and moving towards yourself. It passess throught the barred door. You reach out and easily take it still in the air. The key is yours!

iron key affected by telekinesis

* * *

>levitate door
heavy barred door affected by telekinesis

* * *

>lev bed
Carla's bed not affected by Telekinesis