Alone in Deep Island
An Interactive Fiction by André, Danyele, Henrique, Márcio and Wakim
Release 1 / Serial number 130621 / Inform 7 build 6G60 (I6/v6.32 lib 6/12N) SD

Prision Cell
This is the room you've been kept since you arrived in this cursed place. Here you witnessed the suffering and despair of many subjects. Yesterday a poor girl was so cruelly abused that she died. Whenever an experience like that fails these guards start patrolling more often. I seems they are observing how you behave. Anyway, this is your home now. This cell is so dirty. It looks like a prision. It even smells like a prision! 

An old wooden table is on the corner. So old and fragile. You can even see the trails of termite. There is an oil lamp on the table.

You can also see a bed here.

>n
You can't go that way.

* * *

>look
Prision Cell
This is the room I've been kept since I arrived in this cursed place. Here I witnessed the suffering and despair of many patients... or should I say prisioners?! Yesterday a poor girl was so cruelly abused that she died. Whenever an experience like that fails these guards start patrolling more often. I think they are observing how I behave. Anyway, this is my home now.

An old wooden table.

>take table
Taken.

>i
You are carrying:
  a table

* * *

>take table
Taken.

>i
You are carrying:
  an old table

* * *

>l
Prision Cell
This cell is so dirty. It looks like a prison. Actually, It smells like a prison!  Anyway, this is your home now.

An old wooden table is on the corner. There is an oil lamp on the table.

* * *

>s
Small Corridor

>n
Prision Cell
This cell is so dirty. It looks like a prision. It even smells like a prision!  Anyway, this is your home now.

An old wooden table is on the corner. So old and fragile. You can even see the trails of termite. There is an oil lamp on the table.

You can also see a bed here.

* * *

>s
Small Corridor

>e
Dark Room

>w
Small Corridor

>n
Prision Cell
This cell is so dirty. It looks like a prision. It even smells like a prision!  Anyway, this is your home now.

An old wooden table is on the corner. So old and fragile. You can even see the trails of termite. There is an oil lamp on the table.

You can also see a bed here.

* * *

>s
Small Corridor

>s
Study

>s
Video Room

>s
You can't go that way.

I beg your pardon?

>n
Study

>n
Small Corridor

>n
Prision Cell
This cell is so dirty. It looks like a prision. It even smells like a prision!  Anyway, this is your home now.

An old wooden table is on the corner. So old and fragile. You can even see the trails of termite. There is an oil lamp on the table.

You can also see a bed here.

* * *

>s
You can't go that way.

>n
Study

* * *

>n
Small Corridor

>w
Art Corridor

>w
Main Hall

>e
Art Corridor

>s
Bar

>s
You can't go that way.

>n
Art Corridor

>e
Small Corridor

>n
Prision Cell
This cell is so dirty. It looks like a prision. It even smells like a prision!  Anyway, this is your home now.

An old wooden table is on the corner. So old and fragile. You can even see the trails of termite. There is an oil lamp on the table.

You can also see a bed here.

* * *

>s
Small Corridor

>w
Art Corridor

>w
You can't go that way.

* * *

>a
That's not a verb I recognise.

>s
small corridor

>c
That's not a verb I recognise.

I beg your pardon?

>n
Prision Cell
This cell is so dirty. It looks like a prision. It even smells like a prision!  Anyway, this is your home now.

An old wooden table is on the corner. So old and fragile. You can even see the trails of termite. There is an oil lamp on the table.

You can also see a bed here.

* * *

>e
Another Cell

>w
Prision Cell
This cell is so dirty. It looks like a prision. It even smells like a prision!  Anyway, this is your home now.

An old wooden table is on the corner. So old and fragile. You can even see the trails of termite. There is an oil lamp on the table.

You can also see a bed here.