Alone in Deep Island
An Interactive Fiction by IM/EBA Alliance of Game Masters
Release 1 / Serial number 130627 / Inform 7 build 6G60 (I6/v6.32 lib 6/12N) SD

Carla's Cell
This is the room you've been kept since you arrived in this cursed place. Here you witnessed the suffering and despair of many subjects. Yesterday a poor girl was so cruelly abused that she died. Whenever an experience like that fails these guards start patrolling more often. It seems they are observing how you behave. 

This cell is so dirty. It looks like a prison. It even smells like a prison. An uncomfortable iron bed is on the corner of the room. There is also a window on the east wall. You can see the other cells through it.

A barred door leads southeast to the prison hall.

Through the barred door you can see a keeper sleeping noisily outside. He is sitting on a chair on the corner of the prison hall. An iron key hanging on his belt catches your eyes.

>tele bed
Carla's bed affected by telekinesis

* * *

>force choke bes
You can't see any such thing.

>force choke bed
You cannot do that!

* * *

>fc bed
You cannot kill something that is not alive... or can you?

>fc me
You cannot do that!

>fc Carla
You can't see any such thing.

>l
Carla's Cell
This cell is so dirty. It looks like a prision. It even smells like a prision!  Anyway, this is your home now.

You can see a keeper sleeping outside, bending on a chair. A ring of iron keys is on his belt.
You can see a heavy barred door and Carla's bed here.

>lev
That's not a verb I recognise.

* * *

>lev iron key
You focus you thoughts on the key. Suddenly, but gently, it starts levitating and moving towards yourself. It passess throught the barred door. You reach out and easily take it still in the air. The key is yours!

>i
You are carrying:
  an iron key

>unlock door
(with the iron key)
You unlock the heavy barred door.

>sw
You can't go that way.

>se
(first opening the heavy barred door)

Prison Hall
An old wooden table is on the corner. So old and rot that you can even see the trails of termite.

You can also see a rusty barred door, a heavy barred door, a wooden char and the keeper here.

>pyro table
You don't have learned the Pyrokinesis Yet

* * *

>lev iron key
You focus you thoughts on the key. Suddenly, but gently, it starts levitating and moving towards yourself. It passess throught the barred door. You reach out and easily take it still in the air. The key is yours!

>unlock door
(with the iron key)
You unlock the heavy barred door.

* * *

>se
(first opening the heavy barred door)

Prison Hall
An old wooden table is on the corner. So old and rot that you can even see the trails of termite.

You can also see a rusty barred door, a heavy barred door, a wooden char and the keeper here.

>nw
Carla's Cell
This cell is so dirty. It looks like a prision. It even smells like a prision.  Anyway, this is your home now.

You can see a heavy barred door and Carla's bed here.

* * *

>unlock door
(with the iron key)
You unlock the heavy barred door.

>se
(first opening the heavy barred door)

Prison Hall
A barred door leads southwest to the prison hall.

An old wooden table is on the corner. So old and rot that you can even see the trails of termite.

You can also see a rusty barred door, a wooden char and the keeper here.

>nw
Carla's Cell
This cell is so dirty. It looks like a prision. It even smells like a prision.  Anyway, this is your home now.

A barred door leads southwest to the prison hall.

You can also see Carla's bed here.

>x door
The heavy barred door door it's just a door, do you know how to use one?
The door is open.

* * *

>pyro bed
You haven't learned the Pyrokinesis yet.

* * *

>fc bed
You cannot do that!

>take bed
That's fixed in place.

>move bed
It is fixed in place.

* * *

>lev window
It is fixed in place.

* * *

>se
(first opening the heavy barred door)
It seems to be locked.

* * *

>x window
It is made of bolletproof glass. You can see another "patient" chained in straitjacket in the next room. She looks so bleak. Maybe the "treatment" is working...

* * *

>lev key
You focus you thoughts on the key. Suddenly, but gently, it starts levitating and moving towards yourself. It passess throught the barred door. You reach out and easily take it still in the air. The key is yours!

>unlock door
(with the iron key)
You unlock the heavy barred door.

>se
(first opening the heavy barred door)

Prison Hall
A barred door leads southeast to the prison hall.

An old wooden table is on the corner. So old and rot that you can even see the trails of termite.

You can also see a heavy iron door, a rusty barred door, a wooden char and the keeper here.

>s
(first opening the heavy iron door)

Corridor
You can see a black door, a knowledge door and a heavy iron door here.