Alone in Deep Island
An Interactive Fiction by André, Danyele, Henrique, Márcio and Wakim
Release 1 / Serial number 130626 / Inform 7 build 6G60 (I6/v6.32 lib 6/12N) SD

Carla's Cell
This is the room you've been kept since you arrived in this cursed place. Here you witnessed the suffering and despair of many subjects. Yesterday a poor girl was so cruelly abused that she died. Whenever an experience like that fails these guards start patrolling more often. I seems they are observing how you behave. Anyway, this is your home now. This cell is so dirty. It looks like a prision. It even smells like a prision! 

You can see a heavy barred door and a Carla's bed here.

>take key
You can't see any such thing.

* * *

>s
You can't go that way.

>x door
You see nothing special about the heavy barred door.

* * *

>s
You can't go that way.

>sw
You can't go that way.

>se
(first opening the heavy barred door)

Prison Hall
An old wooden table is on the corner. So old and rot that you can even see the trails of termite.

You can also see a rusty barred door, a heavy barred door, a chair and keeper here.

>x keeper
You see nothing special about keeper.

>say hi
(to keeper)
There is no reply.

>take key
That seems to belong to keeper.

* * *

>se
(first opening the heavy barred door)

Prison Hall
An old wooden table is on the corner. So old and rot that you can even see the trails of termite.

You can also see a rusty barred door, a heavy barred door, a chair and keeper here.

>s
Corridor
You can see Knowledge door here.

>n
Prison Hall
An old wooden table is on the corner. So old and rot that you can even see the trails of termite.

You can also see a rusty barred door, a heavy barred door, a chair and keeper here.

>s
Corridor
You can see Knowledge door here.

* * *

>sit
What do you want to sit on?

>bed
That's not something you can sit down on.

>sit
What do you want to sit on?

>floor
You can't see any such thing.

>sit
What do you want to sit on?

>ground
You can't see any such thing.

>sit
What do you want to sit on?

>me
But you're already in yourself.

>enter me
But you're already in yourself.

>jump
You jump on the spot, fruitlessly.

>dance
That's not a verb I recognise.

>say ji
(to yourself)
There is no reply.

* * *

>se
(first opening the heavy barred door)

Prison Hall
An old wooden table is on the corner. So old and rot that you can even see the trails of termite.

You can also see a rusty barred door, a heavy barred door, a chair and keeper here.

>s
Corridor
You can see a knowledge door here.

>e
black door

>e
Dark Room

* * *

>l s
You see nothing unexpected in that direction.

>lse
That's not a verb I recognise.

>l se
You see nothing unexpected in that direction.

>x se
You see nothing unexpected in that direction.

>se
(first opening the heavy barred door)

Prison Hall
An old wooden table is on the corner. So old and rot that you can even see the trails of termite.

You can also see a rusty barred door, a heavy barred door, a chair and keeper here.

>s
Corridor
You can see a black door and a knowledge door here.

I beg your pardon?

I beg your pardon?

>e
(first opening the black door)

Dark Room
You can see a black door here.

* * *

>sit be
I didn't understand that sentence.

>sit on bed
That's not something you can sit down on.

* * *

>sit on bed
You are now seated on the iron bed.

>se
(first getting off the iron bed)
(first opening the heavy barred door)

Prison Hall
An old wooden table is on the corner. So old and rot that you can even see the trails of termite.

You can also see a rusty barred door, a heavy barred door and keeper here.

* * *

>look
Carla's Cell
This cell is so dirty. It looks like a prision. It even smells like a prision!  Anyway, this is your home now.

You can see a heavy barred door and a Carla's bed here.

>open door
You open the heavy barred door.

>look
Carla's Cell
This cell is so dirty. It looks like a prision. It even smells like a prision!  Anyway, this is your home now.

You can see a heavy barred door, an iron bed and a window here.

>pick up lamp
You can't see any such thing.

>look lamp
You can't see any such thing.

>look lamp
You can't see any such thing.

>sit ground
I only understood you as far as wanting to sit.

>s
You can't go that way.

>n
You can't go that way.

>l
Carla's Cell
This cell is so dirty. It looks like a prision. It even smells like a prision!  Anyway, this is your home now.

You can see a heavy barred door, an iron bed and a window here.

>e
You can't go that way.

>l
Carla's Cell
This cell is so dirty. It looks like a prision. It even smells like a prision!  Anyway, this is your home now.

You can see a heavy barred door, an iron bed and a window here.

>w
You can't go that way.

>look window
You see nothing special about the window.

>go prison hall
You can't see any such thing.

>door
That's not a verb I recognise.

>open door
That's already open.

>leave door
I only understood you as far as wanting to leave.

>go prison
You can't see any such thing.

>pick old table
You can't see any such thing.

>get out
But you aren't in anything at the moment.

>where
That's not a verb I recognise.

>who
That's not a verb I recognise.

>location
That's not a verb I recognise.

>p
That's not a verb I recognise.

>go p
You can't see any such thing.

>go prison hall
You can't see any such thing.

>look keeper
You can't see any such thing.

>look
Carla's Cell
This cell is so dirty. It looks like a prision. It even smells like a prision!  Anyway, this is your home now.

You can see a heavy barred door, an iron bed and a window here.

>use door
That's not a verb I recognise.

>leave door
I only understood you as far as wanting to leave.

* * *

>look
Carla's Cell
This cell is so dirty. It looks like a prision. It even smells like a prision!  Anyway, this is your home now.

You can see a heavy barred door and a Carla's bed here.

>look window
You see nothing special about the window is.

>get window
Taken.

>inventory
You are carrying:
  a window is

* * *

>look
Carla's Cell
This cell is so dirty. It looks like a prision. It even smells like a prision!  Anyway, this is your home now.

You can see a heavy barred door and a Carla's bed here.

>i
You are carrying nothing.

* * *

>look
Carla's Cell
This cell is so dirty. It looks like a prision. It even smells like a prision!  Anyway, this is your home now.

You can see a heavy barred door and a Carla's bed here.

>look door
You can't see any such thing.

>get knife
You can't see any such thing.

* * *

>look door
You can't see any such thing.

>open door
You open the heavy barred door.

>go door
Prison Hall
An old wooden table is on the corner. So old and rot that you can even see the trails of termite.

You can also see a rusty barred door, a heavy barred door, a wooden char and Keeper here.

>look
Prison Hall
An old wooden table is on the corner. So old and rot that you can even see the trails of termite.

You can also see a rusty barred door, a heavy barred door, a wooden char and Keeper here.

>talk Keeper
That's not a verb I recognise.

* * *

>look
Carla's Cell
This cell is so dirty. It looks like a prision. It even smells like a prision!  Anyway, this is your home now.

You can see a heavy barred door and a Carla's bed here.

>get knife
Taken.

>look
Carla's Cell
This cell is so dirty. It looks like a prision. It even smells like a prision!  Anyway, this is your home now.

You can see a heavy barred door and a Carla's bed here.

>examine door
It is pitch dark, and you can't see a thing.

>look door
It is pitch dark, and you can't see a thing.

>get knife
You can't see any such thing.

>go door
(first opening the heavy barred door)

Prison Hall
An old wooden table is on the corner. So old and rot that you can even see the trails of termite.

You can also see a rusty barred door, a heavy barred door, a wooden char and Keeper here.

>look
Prison Hall
An old wooden table is on the corner. So old and rot that you can even see the trails of termite.

You can also see a rusty barred door, a heavy barred door, a wooden char and Keeper here.

>look door
Which do you mean, the rusty barred door or the heavy barred door?

>look heavy door
The heavy barred door door it's just a door, do you know how to use one?
The door is open.

>examine
What do you want to examine?

* * *

>look
Carla's Cell
This cell is so dirty. It looks like a prision. It even smells like a prision!  Anyway, this is your home now.

You can see a heavy barred door and a Carla's bed here.

>go s
Near southDarkness
It is pitch dark, and you can't see a thing.

>go s
Near southDarkness
It is pitch dark, and you can't see a thing.

>go e
Near eastDarkness
It is pitch dark, and you can't see a thing.

>s
Near southDarkness
It is pitch dark, and you can't see a thing.

* * *

>look
Carla's Cell
This cell is so dirty. It looks like a prision. It even smells like a prision!  Anyway, this is your home now.

You can see a heavy barred door and a Carla's bed here.

>look dor
You can't see any such thing.

>look door
You can't see any such thing.

>see
That's not a verb I recognise.

>check
What do you want to check?

>s
It is pitch dark, and you can't see a thing.