Alone in Deep Island
An Interactive Fiction by André, Danyele, Henrique, Márcio and Wakim
Release 1 / Serial number 130627 / Inform 7 build 6G60 (I6/v6.32 lib 6/12N) SD

Carla's Cell
This is the room you've been kept since you arrived in this cursed place. Here you witnessed the suffering and despair of many subjects. Yesterday a poor girl was so cruelly abused that she died. Whenever an experience like that fails these guards start patrolling more often. I seems they are observing how you behave. Anyway, this is your home now. This cell is so dirty. It looks like a prision. It even smells like a prision! 

You can see a keeper sleeping outside, bending on a chair. A ring of iron keys is on his belt.
You can see a heavy barred door and Carla's bed here.

>take iron key
You cannot reach the keeper's belt.

>levitate iron key
You focus you thoughts on the key. Suddenly, but gently, it starts levitating and moving towards yourself. It passess throught the barred door. You reach out and easily take it still in the air. The key is yours!

>sw
You can't go that way.

>se
(first opening the heavy barred door)
It seems to be locked.

>unlock door
(with the iron key)
You unlock the heavy barred door.

>se
(first opening the heavy barred door)

Prison Hall
An old wooden table is on the corner. So old and rot that you can even see the trails of termite.

You can also see a rusty barred door, a heavy barred door, a wooden char and the keeper here.

* * *

>levitate iron key / unlock door / se
I only understood you as far as wanting to levitate the iron key.

* * *

>x window
Description of window